1111111111111
100000E000011
1P0000CCC0001
1001000C00001
1111111111111